+---+---+---+---+---+
|   |               |
+   +---+---+---+   +
|                   |
+---+---+---+---+   +
|   |               |
+   +   +---+---+---+
|   |   |       |   |
+   +   +   +   +   +
|           |       |
+---+---+---+---+---+