+---+---+---+---+---+---+---+---+---+---+---+---+---+---+---+---+---+---+---+---+---+---+---+---+---+
|   |                   |           |               |                           |                   |
+   +---+   +---+---+   +   +---+   +---+---+   +   +   +---+   +   +---+---+---+   +---+---+   +   +
|           |       |       |   |           |   |           |   |   |           |   |       |   |   |
+---+---+---+   +   +---+---+   +---+---+   +---+---+---+   +   +---+   +---+   +   +   +   +   +   +
|               |   |               |   |           |       |               |           |   |   |   |
+   +---+---+---+   +   +---+---+   +   +---+---+   +---+---+   +---+---+---+   +---+---+---+   +   +
|   |           |       |       |               |           |       |       |   |   |           |   |
+   +   +   +---+---+---+   +---+---+---+   +---+---+---+   +---+---+   +   +   +   +   +---+---+   +
|   |   |               |                   |           |           |   |   |   |   |       |       |
+   +---+   +---+   +---+   +---+---+---+---+   +---+   +---+---+   +   +   +   +   +---+   +---+---+
|       |   |   |           |   |               |               |   |   |   |       |   |           |
+   +   +   +   +---+---+---+   +   +---+---+---+   +---+---+   +   +   +   +---+   +   +---+---+   +
|   |   |                       |           |   |   |       |   |       |   |                   |   |
+   +   +   +---+---+---+---+---+---+---+   +   +   +---+   +   +---+---+   +---+---+   +---+---+   +
|   |   |   |                               |   |       |               |       |       |       |   |
+   +   +---+   +---+---+---+---+---+---+---+   +---+   +---+---+---+   +---+   +   +---+   +   +   +
|   |           |           |                       |           |           |   |   |       |       |
+   +---+---+---+   +   +   +   +---+---+   +---+---+---+---+   +---+---+   +   +---+   +---+---+   +
|           |       |   |   |       |   |                   |       |       |           |       |   |
+---+---+   +---+   +   +   +---+   +   +---+---+   +---+---+---+   +---+---+---+---+---+   +---+   +
|       |       |   |   |       |       |       |               |                   |               |
+   +   +---+   +---+   +---+   +---+   +   +   +---+---+---+   +---+---+---+---+   +   +---+---+---+
|   |   |   |       |       |       |       |               |           |       |       |           |
+   +   +   +---+   +---+   +---+   +   +---+---+---+   +---+---+   +   +   +---+---+---+---+---+   +
|   |           |       |   |   |   |   |       |       |           |   |                       |   |
+   +---+---+---+---+   +   +   +   +---+   +   +   +---+   +---+---+   +---+   +---+---+---+   +   +
|           |       |   |   |   |           |   |   |       |       |           |           |   |   |
+   +---+   +   +   +   +   +   +---+---+---+   +---+   +---+   +---+---+---+---+   +   +---+   +   +
|       |       |           |                           |                           |               |
+---+---+---+---+---+---+---+---+---+---+---+---+---+---+---+---+---+---+---+---+---+---+---+---+---+