+---+---+---+---+---+---+---+---+---+---+---+---+---+---+---+---+---+---+---+---+
|   |   |                   |   |               |                               |
+   +   +   +---+---+   +   +   +   +---+   +---+   +---+---+---+---+---+   +---+
|   |       |           |   |   |   |   |           |                   |       |
+   +   +---+   +---+---+   +   +   +   +---+---+---+---+   +---+---+   +---+   +
|   |   |       |       |   |   |                           |       |       |   |
+   +---+   +---+   +---+   +   +   +---+---+---+   +---+---+   +---+---+   +   +
|           |               |   |   |           |   |       |               |   |
+---+---+---+   +---+---+---+   +   +   +---+   +---+   +   +   +---+---+---+   +
|           |   |           |       |       |           |   |   |               |
+   +---+---+   +   +   +---+   +---+---+   +---+---+---+   +---+   +---+---+   +
|   |           |   |   |       |       |       |       |       |   |           |
+   +   +---+---+   +---+   +---+   +---+---+   +   +   +---+   +   +   +---+---+
|   |   |           |       |       |           |   |       |   |   |       |   |
+   +   +---+   +---+   +---+   +   +   +---+---+---+   +   +   +   +---+   +   +
|   |       |       |       |   |   |               |   |       |   |   |   |   |
+   +---+   +---+   +---+   +   +   +---+---+---+   +---+---+   +   +   +   +   +
|       |       |               |               |           |       |   |       |
+   +---+---+   +---+---+---+---+---+---+---+---+---+---+   +---+---+   +---+   +
|                                                           |                   |
+---+---+---+---+---+---+---+---+---+---+---+---+---+---+---+---+---+---+---+---+